--------------
|............|
|............+#####        ------------------
|............|    #        |................|
--------------    #        |................|
                  #        |................|
                  #########+................|
                           |................|
                           ------------------
